111111111111111111
1P00000000000000E1
101111111111111011
101H00000000001011
10101111111101011
10101V00K00101011
10101011110101011
10101V00K00101011
10101111111101011
101H00000000001011
101111111111111011
101000V000V000101
101011111111111011
10M000000000000X1
111111111111111111