111111111111111111
1P00000000000000E1
1K1111111111111011
100H00000000001011
101011111100101011
10101V00K0V0101011
101010111100101011
10101000K000101011
101011111111101011
101H00000000V01K11
101111111111111011
101000000000000011
101V01111111111111
10M0000000000000X1
111111111111111111