111111111111111111
1P010K010K010K01E1
1001M001000100M101
1000000000M0000001
110110110110110111
100000000000000001
100000000000000001
100000000000000001
110110110110110111
100000000000000001
10000001K010000001
110110110110110111
100000000000000001
1E00000000000000X1
111111111111111111
