111111111111111111
1P0000000000000001
101111111011111101
101000001010000001
101011101010111101
10101K101010100001
101011101010101101
101000001010101001
101111111011111011
100000000000000001
101111111111111011
1010000000000E0001
101011111111111011
1M000H00V000000X1
111111111111111111
