111111111111111111
1P0KM10001000000E1
111101010101111101
100000010001000001
101111111111011111
101000H00000010001
101011111111110101
10101000V000010101
101010111111010101
100010100M01010101
111110101101010101
100000101001010001
101111101111011111
1K0000000E000000X1
111111111111111111
