111111111111111111
1P00000000000000E1
111111111111111101
1K0V0V0V0V0V0V0101
100000000000000101
111111111111110101
100000000000010101
101111111111110101
1010V0V0V0V0V0V0K1
101000000000000001
101111111111111111
10K0V0V0V0V0V0V011
100000000000000011
1000000000000000X1
111111111111111111
