111111111111111111
1P0000000000000001
111111111111111101
10H000000000000001
101111111111111111
100000000000000H01
111111111111111101
10K0H0000000000001
101111111111111111
100000000000000K01
111111111111111101
100H00000000000001
101111111111111111
1K00000000000000X1
111111111111111111
